##.....@@#
#........#
...####..#
......#..#
......#..#
.#....#..#
.#.......#
.#.......#
.##......#
.........#
.........#
.....##..#
......#..#
......#..#
.#....#..#
.#.......#
.#.......#
.####....#
.......#.#
.@@...####