##...$.!.#
#...&....#
...####..#
......#..#
......#..#
.#....#..#
.#.......#
.#.......#
.##......#
.........#
.........#
.....##..#
......#..#
......#..#
.#....#..#
.#.......#
.#.......#
?####....#
.%.....#.#
.@....####