##...%.!.#
#...?....#
...####..#
......#..#
......#..#
.#....#..#
.#.......#
.#.......#
.##......#
.........#
.........#
.....##..#
......#..#
......#..#
.#....#..#
.#.......#
.#.......#
&####....#
.$.....#.#
.@....####