##########
#?..?%.!.#
#..####..#
#.....#..#
......#.?#
.#.##.#..#
.#.......#
.#.......#
.##...##.#
......##.#
#........#
#....##..#
#.....#..#
......#..#
.#.##.#..#
.#.......#
.#.......#
&####....#
#$.....#&#
#@.#######
